NO ./temp/among.xpm
SO ./temp/among.xpm
WE ./temp/among.xpm
EA ./temp/among.xpm

F 128,128,128
C 204,255,255

1111111111111111111111111
1E00010000100000000000111
1011010110101111111011101
1010010010001000001010001
1011111010000111101010111
1001001011110000001010001
1101011000011111111011101
1000010001000010000000001
1011110101111110111111111
1000000100010000000000001
1111111111111111111111111